# Format d'une carte.
# Chaque ligne du fichier représente une case de la carte.
# 
# La table de correspondance suivante est utilisée. Le format n'est pas sensible à la casse.
#
# | Symbole | Type de case |
# |---------|--------------|
# | S       | Sable        |
# | P       | Prairie      |
# | F       | Forêts       |
# | R       | Rochers      |
# | X       | Eau          |

             XXXXXXXX
         XXXXXXXXXXXXXXXX
     XXXXXXXXXXXXXXXXXXXXXXX
    XXSSSSSSSXXXXXXSSSSXXXXXXXX
   XXXSPPPPSXXXXXXXSSXSSSXXXXXXXXX
   XXXSSSSSXXXXXXSSPFFFFSSSXXXXXXXXX
  XXXXXXXXXXXXXXXSPPFRRFPPSXXXXXXXXX
 XXXXPPPPPPPXXXXXSSFRRRFPSXXXXXXXXXXX
XXXPPRRRPPPPXXXXXXSFFRFPSXXXXXXXXXXXX
XXPPRRRRPPXXXXXXXXSSPPPSXXXXXXXXXXXXX
 XXPPRRPPPXXXXXXXXXXSSSXXXXXXXXXXXXX
 XXXXPPPXXXXSSSSSSXXXXXXXXXXXXXXX
  XXXXXXXXSSPPPPSSSSXXXXXXXX
   XXXXXSSSSPPPPPPSSXXXXXXXXXX
   XXXXXSSFFFFFFFFFSSXXXXXXXXXXX
      XXXXSSFFFFFFFFFFFFFSSSXXXXX
        XXXSSSSFFFFFFFFSSSSXXXXX
         XXXXXSSSSSFFFFFFSSSXXXX
           XXXXXSSSSFFSSSXXXXX
               XXXSSSSSSSSXXX
                XXXXXXXXXXX





