RRFFFFFXXX
RRFFFFXXXX
FFFXXXXXXX
FFXXSSSSSS
XXXXSFFFFF
XXXXSFFFFF
XXXXSSSSSS
XXXXXXXXXX
RRXXXXXXXX