                                                    XXXXXXXXXXXX                    
                                               XXXXXXXXXXXXXXXXXX                   
                                           XXXXXXXXXXXXXXXXXXXXXXXX                 
                                        XXXXXXXXXXXXXXXXXXXXXXXXXXXX                
                                    XXXXXXXXXXXXXXXXXXXXXXXXXXXXXXXXX               
                                 XXXXXXXXXXXXXXXXXXXXXXXXXXXXXXXXXXXXX              
                              XXXXXXXXXXXXXXXXXXXXXXXXXXXXXXXXXXXXXXXXXX            
                            XXXXXXXXXXXXXXXXXXXXXXXXXXXXXXXXXXXXXXXXXXXXXX          
                          XXXXXXXXXXXXXXXXXXXXXXXXXXXXXXXXXXXXXXXXXXXXXXXXX         
                         XXXXXXXXXXXXXXXXXXXXXXXXXXXSSSSSSSXXXXXXXXXXXXXXXXXX       
                      XXXXXXXXXXXXXXXXXXXXXXXXXXXXSSSSSSSSSSSXXXXXXXXXXXXXXXXX      
                   XXXXXXXXXXXXXXXXXXXXXXXXXXXXXSSSSSSSSSSSSSSSXXXXXXXXXXXXXXXX     
                 XXXXXXXXXXXXXXXXXXXXXXXXXXXXXXSSSSSSSSPPPPSSSSSXXXXXXXXXXXXXXXX    
               XXXXXXXXXXXXXXXXXXXXXXXXXXXXXXXXSSSSSSSPPPPPPSSSSSSXXXXXXXXXXXXXXX   
              XXXXXXXXXXXXXXXXXXXXXXXXXXXXXXXXXSSSSSSSPPPPPPPSSSSSSSXXXXXXXXXXXXX   
             XXXXXXXXXXXXXXXXXXXXXXXXXXXXXXXXXXXSSSSSSPPPPPPPPSSSSSSSSSSXXXXXXXXXX  
           XXXXXXXXXXXXXXXXXXXXXXXXXXXXXXXXXXXXXXSSSSSSPPPPPPPPSSSSSSSSSSSXXXXXXXXX 
          XXXXXXXXXXXXXSSSSXXXXXXXXXXXXXXXXXXXXXXXSSSSSSPPPPPPPPPSSSSSSSSSSSXXXXXXX 
        XXXXXXXXXXXXXSSSSSSSXXXXXXXXXXXXXXXXXXXXXXXXSSSSSPPPPPPPPPPSSSSSSSSSSXXXXXX 
        XXXXXXXXXXXXSSSSSSSSXXXXXXXXXXXXXXXXXXXXXXXXXSSSSSPPPPPPPPPPPSSSSSSSSSXXXXX 
       XXXXXXXXXXXXSSSSSSSSSXXXXXXXXXXXXXXXXXXXXXXXXXXSSSSSPPPPPPPPPPPPSSSSSSSXXXXXX
      XXXXXXXXXXXXSSSSSSSSSXXXXXXXXXXXXXXXXXXXXXXXXXXXXXSSSSSPPPPPPFFPPPPSSSSSSXXXXX
      XXXXXXXXXXXSSSSSSSSSXXXXXXXXXXXXXXXXXXXXXXXXXXXXXXXSSSSSPPPPFFFFFPPPSSSSSXXXXX
     XXXXXXXXXXXXSPPPPSSSXXXXXXXXXXXXXX            XXXXXXXSSSSSPPPFFFFFFPPPSSSSXXXXX
     XXXXXXXXXXSSSPPPPSSSXXXXXXXXXXXX               XXXXXXXSSSSPPPPFFFFFPPPSSSSXXXXX
    XXXXXXXXXXSSSSPPPPSSXXXXXXXXXXXX                 XXXXXXXSSSSPPPFFFFFFPPPSSSXXXXX
   XXXXXXXXXXXSSSPPPPPPSSXXXXXXXXXX                  XXXXXXXXSSSSSPPFFFFFPPPSSSXXXXX
   XXXXXXXXXXSSSPPPFPPPPSSXXXXXXXX                   XXXXXXXXSSSSSPPPFFFFPPPSSSXXXX 
  XXXXXXXXXXXSSSPPFFFPPPSSXXXXXXX                    XXXXXXXXXSSSSSPPFFFFPPSSSXXXXX 
  XXXXXXXXXXXSSPPFFFFPPPSSSXXXXX                     XXXXXXXXXXSSSSPPPFFPPPSSXXXXXX 
  XXXXXXXXXXSSSPPFFRFFPPSSSXXXX                      XXXXXXXXXXSSSSPPPPPPPSSSXXXXXX 
 XXXXXXXXXXSSSPPPFFRFFFPSSSXXXX                      XXXXXXXXXXXSSPPPPPPPSSSXXXXXXX 
 XXXXXXXXXXSSSPPFFFRRFFPPSSXXX                       XXXXXXXXXXXSSPPPPPPSSSXXXXXXX  
 XXXXXXXXXXSSSPPFFRRRFFPPSSXXX                      XXXXXXXXXXXXSSPPPPPSSSSXXXXXXX  
 XXXXXXXXXSSSSPPFFRRRFFPPSSXXX                      XXXXXXXXXXXXSSSSSSSSSSXXXXXXXX  
XXXXXXXXXXSSSPPPFFRRRFFPPSSXXX                      XXXXXXXXXXXXSSSSSSSSSXXXXXXXX   
XXXXXXXXXXSSSPPPFFRRFFPPPSSXXX                     XXXXXXXXXXXXXXSSSSSSSXXXXXXXXX   
XXXXXXXXXSSSSPPFFRRRFFPPPSSXXX                     XXXXXXXXXXXXXXXXXXXXXXXXXXXXXX   
XXXXXXXXXSSSPPPFFRRFFPPPPSSXXX                    XXXXXXXXXXXXXXXXXXXXXXXXXXXXXX    
XXXXXXXXXSSSPPFFFRRFFPPPSSXXXXX                  XXXXXXXXXXXXXXXXXXXXXXXXXXXXXX     
XXXXXXXXXSSSPPFFRRRFPPPPSSXXXXXX               XXXXXXXXXXXXXXXXXXXXXXXXXXXXXXXX     
XXXXXXXXXSSSPPFFFRFFPPPSSSXXXXXXX          XXXXXXXXXXXXXXXXXXXXXXXXXXXXXXXXXXX      
XXXXXXXXXSSSPPFFFFFPPPSSSXXXXXXXXXXXXXXXXXXXXXXXXXXXXXXXXXXXXXXXXXXXXXXXXXXXXX      
XXXXXXXXXSSSPPPFFFFPPPSSXXXXXXXXXXXXXXXXXXXXXXXXXXXXXXXXXXXXXXXXXXXXXXXXXXXXX       
XXXXXXXXXXSSSPPFFFFPPSSXXXXXXXXXXXXXXXXXXXXXXXXXXXXXXXXXXXXXXXXXXXXXXXXXXXXX        
 XXXXXXXXXSSSPPPFFPPPSXXXXXXXXXXXXXXXXXXXXXXXXXXXXXSSSSSSSSSXXXXXXXXXXXXXXX         
  XXXXXXXXXSSPPPPPPPSSXXXXXXXXXXXXXXXXXXXXXXXXXXXSSSSSSFSSSSSXXXXXXXXXXXXX          
   XXXXXXXXXSSPPPPPSSXXXXXXXXXXXXXXXXXXXXXXXXXXSSSSSFFFFFSSSSXXXXXXXXXXXXX          
    XXXXXXXXXSSSSSSSXXXXXXXXXXXXXXXXXXXXXXXXXSSSSSFFFFFFFSSSSXXXXXXXXXXXXX          
     XXXXXXXXXSSSSSXXXXXXXXXXXXXXXXXXXXXXXXXSSSFFFFFFFFFSSSSXXXXXXXXXXXXX           
     XXXXXXXXXXXXXXXXXXXXXXXXXXXXXXXXXXXSSSSSFFFFFFFFFFSSSSXXXXXXXXXXXXX            
      XXXXXXXXXXXXXXXXXXXXXXXXXXXXXXXXXSSSSFFFFFFFFFFFSSSSXXXXXXXXXXXXX             
       XXXXXXXXXXXXXXXXXXXXXXXXXXXXXXXSSSSFFFFFFFFFFSSSSSXXXXXXXXXXXXX              
        XXXXXXXXXXXXXXXXXXXXXXXXXXXXXXSSSFFFFFFFFFSSSSSXXXXXXXXXXXXXX               
          XXXXXXXXXXXXXXXXXXXXXXXXXXXXSSSSFFFFFSSSSSXXXXXXXXXXXXXXXX                
             XXXXXXXXXXXXXXXXXXXXXXXXXXSSSSSSSSSXXXXXXXXXXXXXXXXX                   
                XXXXXXXXXXXXXXXXXXXXXXXXXXXXXXXXXXXXXXXXXXXXXXXX                    
                  XXXXXXXXXXXXXXXXXXXXXXXXXXXXXXXXXXXXXXXXXXXX                      
                      XXXXXXXXXXXXXXXXXXXXXXXXXXXXXXXXXX                            
                            XXXXXXX                                                 